Brocart rouge	Textile > Soie
Brocatelle	Textile > Brocatelle
Brocatelle bleue	Textile > Brocatelle
Brocatelle crème	Textile > Brocatelle
Brocatelle grise	Textile > Brocatelle
Brocatelle jaune	Textile > Brocatelle
Brocatelle orange	Textile > Brocatelle
Brocatelle rose	Textile > Brocatelle
Brocatelle rouge	Textile > Brocatelle
Brocatelle verte	Textile > Brocatelle
Brocatelle violette	Textile > Brocatelle
Broderie	Textile
Bronze	Métal > Bronze
Cannage	Cannage
Coton	Textile > Coton
Coton blanc	Textile > Coton
Coton bleu	Textile > Coton
Coton jaune	Textile > Coton
Coton orange	Textile > Coton
Coton rose	Textile > Coton
Coton rouge	Textile > Coton
Coton vert	Textile > Coton
Crin	
Crin blanc	
Crin bleu	
Crin crème	
Crin gris	
Crin jaune	
Crin marron	
Crin noir	
Crin orange	
Crin rose	
Crin rouge	
Crin vert	
Cuir	Cuir et skaï > Cuir
Cuir beige	Cuir et skaï > Cuir
Cuir blanc	Cuir et skaï > Cuir
Cuir bleu	Cuir et skaï > Cuir
Cuir bordeaux	Cuir et skaï > Cuir
Cuir fauve	Cuir et skaï > Cuir
Cuir gris	Cuir et skaï > Cuir
Cuir havane	Cuir et skaï > Cuir
Cuir jaune	Cuir et skaï > Cuir
Cuir marron	Cuir et skaï > Cuir
Cuir noir	Cuir et skaï > Cuir
Cuir orange	Cuir et skaï > Cuir
Cuir rose	Cuir et skaï > Cuir
Cuir rouge	Cuir et skaï > Cuir
Cuir vert	Cuir et skaï > Cuir
Cuir violet	Cuir et skaï > Cuir
Daim bleu	Cuir et skaï > Daim
Damas beige	Textile > Damas
Damas blanc	Textile > Damas
Damas bleu	Textile > Damas
Damas crème	Textile > Damas
Damas gris	Textile > Damas
Damas jaune	Textile > Damas
Damas marron	Textile > Damas
Damas rose	Textile > Damas
Damas rouge	Textile > Damas
Damas vert	Textile > Damas
Damas violet	Textile > Damas
Dégarni	
Drap beige	Textile
Drap bleu	Textile
Drap crème	Textile
Drap jaune	Textile
Drap marron	Textile
Drap noir	Textile
Drap rose	Textile
Drap rouge	Textile
Drap vert	Textile
Drap violet	Textile
Feutre marron	Textile > Feutre et feutrine
Feutre noir	Textile > Feutre et feutrine
Feutre orange	Textile > Feutre et feutrine
Feutre rose	Textile > Feutre et feutrine
Feutre rouge	Textile > Feutre et feutrine
Feutre vert	Textile > Feutre et feutrine
Feutrine noire	Textile > Feutre et feutrine
Feutrine rouge	Textile > Feutre et feutrine
Feutrine verte	Textile > Feutre et feutrine
Flanelle marron	Textile > Flanelle
Indienne	Textile > Indienne
Jersey beige	Textile > Jersey
Jersey blanc	Textile > Jersey
Jersey bleu	Textile > Jersey
Jersey jaune	Textile > Jersey
Jersey marron	Textile > Jersey
Jersey orange	Textile > Jersey
Jersey rose	Textile > Jersey
Jersey rouge	Textile > Jersey
Jersey vert	Textile > Jersey
Jersey violet	Textile > Jersey
Laine bleue	Textile > Laine
Lampas	Textile > Lampas
Lampas beige	Textile > Lampas
Lampas blanc	Textile > Lampas
Lampas bleu	Textile > Lampas
Lampas crème	Textile > Lampas
Lampas gris	Textile > Lampas
Lampas jaune	Textile > Lampas
Lampas rose	Textile > Lampas
Lampas rouge	Textile > Lampas
Lampas vert	Textile > Lampas
Marbre	Pierre > Marbre
Moire	
Moleskine bleue	Textile > Moleskine
Moleskine jaune	Textile > Moleskine
Moleskine marron	Textile > Moleskine
Moleskine noire	Textile > Moleskine
Moleskine rouge	Textile > Moleskine
Moleskine verte	Textile > Moleskine
Ottoman rose	
Paille	
Peluche marron	Textile > Velours
Peluche rose	Textile > Velours
Peluche rouge	Textile > Velours
Peluche verte	Textile > Velours
Percale crème	Textile > Coton
Percale gris	Textile > Coton
Percale jaune	Textile > Coton
Reps beige	Textile > Reps
Reps blanc	Textile > Reps
Reps bleu	Textile > Reps
Reps crème	Textile > Reps
Reps gris	Textile > Reps
Reps jaune	Textile > Reps
Reps marron	Textile > Reps
Reps noir	Textile > Reps
Reps orange	Textile > Reps
Reps rose	Textile > Reps
Reps rouge	Textile > Reps
Reps vert	Textile > Reps
Reps violet	Textile > Reps
Satin	Textile > Satin
Satin beige	Textile > Satin
Satin blanc	Textile > Satin
Satin bleu	Textile > Satin
Satin crème	Textile > Satin
Satinette jaune	Textile > Satin
Satinette verte	Textile > Satin
Satin gris	Textile > Satin
Satin ivoire	Textile > Satin
Satin jaune	Textile > Satin
Satin marron	Textile > Satin
Satin orange	Textile > Satin
Satin rose	Textile > Satin
Satin rouge	Textile > Satin
Satin vert	Textile > Satin
Satin violet	Textile > Satin
Savonnerie	Textile
Skaï beige	Cuir et skaï > Skaï
Skaï blanc	Cuir et skaï > Skaï
Skaï bleu	Cuir et skaï > Skaï
Skaï crème	Cuir et skaï > Skaï
Skaï gris	Cuir et skaï > Skaï
Skaï jaune	Cuir et skaï > Skaï
Skaï marron	Cuir et skaï > Skaï
Skaï noir	Cuir et skaï > Skaï
Skaï orange	Cuir et skaï > Skaï
Skaï rouge	Cuir et skaï > Skaï
Skaï (simili cuir)	Cuir et skaï > Skaï
Skaï vert	Cuir et skaï > Skaï
Soie	Textile > Soie
Soie beige	Textile > Soie
Soie blanche	Textile > Soie
Soie bleue	Textile > Soie
Soie crème	Textile > Soie
Soie grise	Textile > Soie
Soie jaune	Textile > Soie
Soie marron	Textile > Soie
Soie orange	Textile > Soie
Soie rose	Textile > Soie
Soie rouge	Textile > Soie
Soie verte	Textile > Soie
Soie violette	Textile > Soie
Tapisserie à l'aiguille	Textile
Tapisserie d'Aubusson	Textile
Tapisserie de Beauvais	Textile
Tapisserie de lice	Textile
Tapisserie des Gobelins	Textile
Tapisserie mécanique	Textile
Tissu	Textile
Tissu à motif	Textile
Tissu beige	Textile
Tissu blanc	Textile
Tissu bleu	Textile
Tissu chiné	Textile
Tissu crème	Textile
Tissu framboise	Textile
Tissu gris	Textile
Tissu jaune	Textile
Tissu marron	Textile
Tissu noir	Textile
Tissu rose	Textile
Tissu rouge	Textile
Tissu vert	Textile
Tissu violet	Textile
Toile beige	Textile > Toile
Toile blanche	Textile > Toile
Toile bleue	Textile > Toile
Toile crème	Textile > Toile
Toile grise	Textile > Toile
Toile jaune	Textile > Toile
Toile marron	Textile > Toile
Toile noire	Textile > Toile
Toile orange	Textile > Toile
Toile rose	Textile > Toile
Toile rouge	Textile > Toile
Toile verte	Textile > Toile
Toile violette	Textile > Toile
Velours	Textile > Velours
Velours beige	Textile > Velours
Velours blanc	Textile > Velours
Velours bleu	Textile > Velours
Velours gris	Textile > Velours
Velours jaune	Textile > Velours
Velours marron	Textile > Velours
Velours noir	Textile > Velours
Velours or	Textile > Velours
Velours orange	Textile > Velours
Velours rose	Textile > Velours
Velours rouge	Textile > Velours
Velours vert	Textile > Velours
Velours violet	Textile > Velours
Terme Gédéon	Mapping
Bronze doré	Métal  >  Bronze
Cannage doré	Cannage
Coton gris	Textile  >  Coton
Cuir crème	Cuir et skaï  >  Cuir
Découvert / mise en blanc	
Drap de laine bleu	Textile
Drap de laine jaune	Textile
Drap de laine mauve	Textile
Drap de laine orange	Textile
Faille noisette	Textile  >  Soie
Faille rose	Textile  >  Soie
Faille rouge	Textile  >  Soie
Feutre écru	Textile  >  Feutre et feutrine
Fil doré	
Fil gris	
Filet nylon bleu	
Galuchat doré	
Galuchat gris	
Gourgouran jaune	Textile
Gourgouran vert	Textile
Laine	Textile  >  Laine
Laine kaki	Textile  >  Laine
Laine orange	Textile  >  Laine
Laine verte	Textile  >  Laine
Lin	Textile
Maroquin	Cuir et skaï  >  Cuir
Maroquin bleu	Cuir et skaï  >  Cuir
Maroquin marron	Cuir et skaï  >  Cuir
Maroquin naturel	Cuir et skaï  >  Cuir
Maroquin noir	Cuir et skaï  >  Cuir
Maroquin rouge	Cuir et skaï  >  Cuir
Maroquin vert	Cuir et skaï  >  Cuir
Simili cuir	Cuir et skaï
Simili cuir beige	Cuir et skaï
Simili cuir blanc	Cuir et skaï
Simili cuir bleu	Cuir et skaï
Simili cuir jaune	Cuir et skaï
Simili cuir marron	Cuir et skaï
Simili cuir noir	Cuir et skaï
Simili cuir rouge	Cuir et skaï
Simili cuir vert	Cuir et skaï
Skaï camel	Cuir et skaï  >  Skaï
Tapisserie	Textile
Tapisserie au point	Textile
Tapisserie beige	Textile
Tissu à chevrons	Textile
Tissu à croisillon	Textile
Tissu bleu clair	Textile
Tissu bleu marine	Textile
Tissu bordeaux	Textile
Tissu chiné bleu clair	Textile
Tissu chiné bleu marine	Textile
Tissu chiné écru	Textile
Tissu chiné rouge	Textile
Tissu mordoré	Textile
Tissu multicolore	Textile
Tissu orange	Textile
Tissu rouge brique	Textile
Tissu turquoise	Textile
Toile écrue	Textile  >  Toile
Toile indienne	Textile  >  Toile
Velours bleu ciel	Textile  >  Velours
Velours bleu foncé	Textile  >  Velours
Velours écru	Textile  >  Velours
Velours ocre	Textile  >  Velours
Velours rouge foncé	Textile  >  Velours
Velours rouge-orangé	Textile  >  Velours
Velours vert anis	Textile  >  Velours
Velours vieil or	Textile  >  Velours
Velours vieux rose	Textile  >  Velours